12
************
*S         *
* ******** *
*        * *
* ****** * *
* *      * *
* * **** * *
* * *  E * *
* * ****** *
* *        *
* ******** F
************
