16
****************
*S  *     *    *
*   *  *  *  * *
* ***  *  * 2* *
*      *     * *
* **** * ***   *
* *    *   * * *
* * ***** ** * *
* *       *  * *
*3******* *  * *
*       * *    *
* ***** * * ** *
* *   1   *    *
* * ***   * ** *
* *     **   *F*
****************
