15
***************
*S  *   *  1  *
* * * * * *** *
* *   *   *   *
* *** ***** * *
*   * 2   * * *
*** * *** * * *
*   * *   *   *
* *** * ***** *
*E  * *3  E*  *
* * * ***** ***
* *   4   *  F*
* ***** *** * *
*E    E   5 * *
***************
