16
****************
*S    *      E *
* *** * ****** *
* *   *      * *
* * ******* ** *
* * *    *     *
* * * ** * *** *
* *   *  *   * *
* *** * *** * **
*  3* *     *  *
* * * ******* **
* * *     1    *
* * * * *    * *
* *   * * *  * *
*    E* 2*    F*
****************