10
**********
*S       *
*        *
* ****   *
*    * E *
*    * ***
*  E *   *
* ****   *
*      F *
**********
